1111111111111
110100000C011
1110011111001
1P0011E000001
1111111111111
