1111111111111
1101000000011
1110011111001
1P0011E00C001
1111111111111
